	

	Molten Maps SciFi Asset Pack (v1)

	Created/distributed by Moltenbolt (www.moltenbolt.com) on September 4, 2024
			***********************

	License: (Creative Commons Zero, CC0)
	http://creativecommons.org/publicdomain/zero/1.0/

	This content is free to use in personal, educational and commercial projects.

	It is optional, but if you want to support me further you can credit Moltenbolt, Molten Maps and www.moltenbolt.com 

			***********************

	These asset packs wouldn't be possible without the support of my Patrons, Youtube Subscribers and the awesome devs who buy my extra packs on itch.io, Blender Market and gumroad.
	
	An extra special thanks to my Hewg Boss supporters on Patreon:

	/ LowKey
	/ CD

	Thank you so much for supporting my work, it means the world to me. Deuces ♥♥

			***********************


	Show your support on Patreon: http://patreon.com/moltenbolt
	Youtube channel (tutorials!):
	http://www.youtube.com/@moltenbolt
	Socials for updates:
	http://x.com/moltenbolt
         
                
        %%%%%%%%%%%%%%%%%%%%%%%%%%%%%%%%%%%%%%%%%%%%%%%%%%%%%%%%%%%%%%%%%%%%%%%%%%%%%%%%          
        %%%%%%%%%%%%%%%%%%%%%%%%%%%%%%%%%%%%%+ :*#%%%%%%%%%%%%%%%%%%%%%%%%%%%%%%%%%%%%%%          
        %%%%%%%%%%%%%%%%%%%%%%%%%%%%%%%%%%%* -******%%%%%%%%%%%%%%%%%%%%%%%%%%%%%%%%%%%%          
        %%%%%%%%%%%%%%%%%%%%%%%%%%%%%%%%%= -**********%%%%%%%%%%%%%%%%%%%%%%%%%%%%%%%%%%          
        %%%%%%%%%%%%%%%%%%%%%%%%%%%%%%%= -+++++++*******%%%%%%%%%%%%%%%%%%%%%%%%%%%%%%%%          
        %%%%%%%%%%%%%%%%%%%%%%%%%%%%%- -+++++++++++*******%%%%%%%%%%%%%%%%%%%%%%%%%%%%%%          
        %%%%%%%%%%%%%%%%%%%%%%%%%%%- =+++++++++++++++*******%%%%%%%%%%%%%%%%%%%%%%%%%%%%          
        %%%%%%%%%%%%%%%%%%%%%%%%%. =+++++++++++++++++++*******#%%%%%%%%%%%%%%%%%%%%%%%%%          
        %%%%%%%%%%%%%%%%%%%%%%%: -===+++++++++++++++++++++++****#%%%%%%%%%%%%%%%%%%%%%%%          
        %%%%%%%%%%%%%%%%%%%%%  =================+++++++++++++++***#%%%%%%%%%%%%%%%%%%%%%          
        %%%%%%%%%%%%%%%%%%#  -==============++==+==++++++++++++++***#%%%%%%%%%%%%%%%%%%%          
        %%%%%%%%%%%%%%%%%%.:--=============+=====+++++++++++++++++++**%%%%%%%%%%%%%%%%%%          
        %%%%%%%%%%%%%%%%%%::----===================+++++++++++++++++++%%%%%%%%%%%%%%%%%%          
        %%%%%%%%%%%%%%%%%%::--------===================+=+=+++++++++++%%%%%%%%%%%%%%%%%%          
        %%%%%%%%%%%%%%%%%%::------------=========+++========++++++++++%%%%%%%%%%%%%%%%%%          
        %%%%%%%%%%%%%%%%%%::------------=-=**         ++====++++++++++%%%%%%%%%%%%%%%%%%          
        %%%%%%%%%%%%%%%%%%.:-----------+%@@@@#           .====++++++++%%%%%%%%%%%%%%%%%%          
        %%%%%%%%%%%%%%%%%%.:::-----==%@@@@@@%                =+=++=+++%%%%%%%%%%%%%%%%%%          
        %%%%%%%%%%%%%%%%%%.::::::------#@@@--=              :========+%%%%%%%%%%%%%%%%%%          
        %%%%%%%%%%%%%%%%%%.::::::::::-----*@@+           -============%%%%%%%%%%%%%%%%%%          
        %%%%%%%%%%%%%%%%%%.::::::::::::-------::...::--==-============%%%%%%%%%%%%%%%%%%          
        %%%%%%%%%%%%%%%%%%..::::::::::::::---==----===-------=========%%%%%%%%%%%%%%%%%%          
        %%%%%%%%%%%%%%%%%%..::::::::::::::::::------------------======%%%%%%%%%%%%%%%%%%          
        %%%%%%%%%%%%%%%%%%:.:::::::::::::::::::::------------------===%%%%%%%%%%%%%%%%%%          
        %%%%%%%%%%%%%%%%%%..::::::::::::-=+*#*+=----------------------%%%%%%%%%%%%%%%%%%          
        %%%%%%%%%%%%%%%%%%..::::::::::::::::::::::::::::--------------%%%%%%%%%%%%%%%%%%          
        %%%%%%%%%%%%%%%%%%..:.:..:::.::::::::::::::::::::::::---------%%%%%%%%%%%%%%%%%%          
        %%%%%%%%%%%%%%%%%%..:..............:::::::::::::::::::--------%%%%%%%%%%%%%%%%%%          
        %%%%%%%%%%%%%%%%%%......................:::::::::::::::::----*%%%%%%%%%%%%%%%%%%          
        %%%%%%%%%%%%%%%%%%-::.....................::::::::::::::::-#%%%%%%%%%%%%%%%%%%%%          
        %%%%%%%%%%%%%%%%%%%%--.....................::::::::::::::#%%%%%%%%%%%%%%%%%%%%%%          
        %%%%%%%%%%%%%%%%%%%%%%=-...................:::::::::::-#%%%%%%%%%%%%%%%%%%%%%%%%          
        %%%%%%%%%%%%%%%%%%%%%%%%=:..................:::::::::%%%%%%%%%%%%%%%%%%%%%%%%%%%          
        %%%%%%%%%%%%%%%%%%%%%%%%%%+:.................:::::-%%%%%%%%%%%%%%%%%%%%%%%%%%%%%          
        %%%%%%%%%%%%%%%%%%%%%%%%%%%%+:.............:::::-%%%%%%%%%%%%%%%%%%%%%%%%%%%%%%%          
        %%%%%%%%%%%%%%%%%%%%%%%%%%%%%%*-:.........::::-%%%%%%%%%%%%%%%%%%%%%%%%%%%%%%%%%          
        %%%%%%%%%%%%%%%%%%%%%%%%%%%%%%%%*-:.:..:::::=%%%%%%%%%%%%%%%%%%%%%%%%%%%%%%%%%%%          
        %%%%%%%%%%%%%%%%%%%%%%%%%%%%%%%%%%#-::::::=%%%%%%%%%%%%%%%%%%%%%%%%%%%%%%%%%%%%%          
        %%%%%%%%%%%%%%%%%%%%%%%%%%%%%%%%%%%%#-::+%%%%%%%%%%%%%%%%%%%%%%%%%%%%%%%%%%%%%%%          
        %%%%%%%%%%%%%%%%%%%%%%%%%%%%%%%%%%%%%%%%%%%%%%%%%%%%%%%%%%%%%%%%%%%%%%%%%%%%%%%%          
       